; = [display.GREEN, display.BLACK, ';', True]
# = [display.WHITE, display.BLACK, '#', False]
O = [display.BLUE, display.BLACK, 'O', False]
end
;;;;;;;;;;;;;;;;;;;;;;;;;;;;;;;;;;;;;;;;;;;;;;;;;;
;;;;;;;;;;;;;;;;;;;;;;;;;;;;;;;;;;;;;;;;;;;;;;;;;;
;;;;;;;;;;;;;;;;;;;;;;;;;;;;;;;;;;;;;;;;;;;;;;;;;;
;;;;;;;;;;;;;;;;;;;;;;;;;;;;;;;;;;;;;;;;;;;;;;;;;;
;;;;;;;;;;;;;;;;;;;;;;;;;;;;;;;;;;;;;;;;;;;;;;;;;;
;;;;;;;;;;;;;;;;;;;;;;#######;;;;;;;;;;;;;;;;;;;;;
;;;;;;;;;;;;;;;;;;;;;;#.....#;;;;;;;;;;;;;;;;;;;;;
;;;;;;;;;;;;;;;;;;;;;;#.....#;;;;;;;;;;;;;;;;;;;;;
;;;;;;;;;;;;;;;;;;;;;;#.....#;;;;;;;;;;;;;;;;;;;;;
;;;;;;;;;;;;;;;;;;;;;;#.....#;;;;;;;;;;;;;;;;;;;;;
;;;;;;;;;;;;;;;;;;;;;;###.###;;;;;;;;;;;;;;;;;;;;;
;;;;;;;;;;;;;;;;;;;;;;;;;;;;;;;;;;;;;;;;;;;;;;;;;;
;;;;;;;;;;;;;;;;;;;;;;;;;W;;;;;;;;;;;;;;;;;;;;;;;;
;;;;;;;;;;;;;;;;;;;;;;;;ASD;;;;;;;;;;;;;;;;;;;;;;;
;;;;;;;;;;;;;;;;;;;;;;TO MOVE;;;;;;;;;;;;;;;;;;;;;
;;;;;;;;;;;;;;;;;;;;;;;;;;;;;;;;;;;;;;;;;;;;;;;;;;
;;;;;;;;;;;;;;;;;;;;;;O=Portal;;;;;;;;;;;;;;;;;;;;
;;;;;;;;;;;;;;;;;;;YOU;>;;;<;YOU;;;;;;;;;;;;;;;;;;
;;;;;;;;;;;;;;;;;;;;;;;;;;;;;;;;;;;;;;;;;;;;;;;;;;
;;;;;;;;;;;;;;;;;;;;;;;;;;;;;;;;;;;;;;;;;;;;;;;;;;
