# = [display.WHITE, display.BLACK, '#', False]
. = [display.WHITE, display.BLACK, '.', True]
! = [display.YELLOW, display.BLACK, '!', False]
* = [display.GREEN, display.BLACK, '*', True]
end.
########################.#########################
#****#...........................................#
#****............................................#
#****#...........................................#
##################################################
#****#........................................#!!#
###**#.........................................#!#
#..............................................###
#.............................................####
#.................................................
#.............................................####
#..............................................###
#.................................##--##.........#
#..###*###......................##******##.......#
#..#*****#.....................#**********#......#
#..#*****#.....................#**********#......#
#..#*****#......................##******##.......#
#..#######........................######.........#
#................................................#
##################################################
