. = [display.WHITE, display.BLACK, '.', True]
# = [display.WHITE, display.BLACK, '#', False]
* = [display.WHITE, display.BLACK, ' ', True]
@ = [display.MAGENTA, display.BLACK, '@', True]
% = [display.MAGENTA, display.BLACK, '%', True]
O = [display.RED, display.BLACK, 'O', True]
end.
********#.........................................
********#.........................................
*******#..........................................
*******#..........................................
*******...........................................
****##............................................
***#..............................................
###......................@@.......................
........................@%%@......................
.......................@%OO%@.....................
.......................@%OO%@.....................
........................@%%@......................
.........................@@.......................
..................................................
..................................................
..................................................
..................................................
..................................................
..................................................
..................................................
