. = [display.WHITE, display.BLACK, '.', True]
# = [display.WHITE, display.BLACK, '#', False]
* = [display.WHITE, display.BLACK, ' ', True]
end.
.........................................#********
.........................................#********
..........................................#*******
..........................................#*******
...........................................*******
............................................##****
..............................................#***
...............................................###
..................................................
..................................................
..................................................
..................................................
..................................................
..................................................
..................................................
..................................................
..................................................
..................................................
..................................................
..................................................
