. = [display.WHITE, display.BLACK, '.', True]
# = [display.WHITE, display.BLACK, '#', False]
^ = [display.RED, display.BLACK, '.', True]
L = [display.RED, display.RED, '#', True]
end^
################.#################################
#^^^^^^LLLLLL^^^^^^^^^^^^^^^^^^^^^^^^^^^^^^^.....#
#^^^^^^^^LLLLL^^^^^^^^^^^^^^^^^^^^^^^^^^^^^^^^...#
#^^^^^^^LLLLL^^^^^^^^^^^^^^^^^^^^^^^^^^^^^^^^^^..#
#^^^^^^^^LLLLL^^^^^^^^^^^^^^^^^^^^^^^^^^^^^^^^^^.#
#^^^^^^^^^LLLLL^^LLLLLLLL^^^^^^^^^^^^^^^^^^^^^^^.#
#^^^^^^^^^LLLLLLLLLLLLLLLLLLL^^^^^^^^^^^^^^^^^^^^#
#^^^^^^^^^^LLLLLLLLLLLLLLLLLLLL^^^^^^^^^^^^^^^^^^#
#^^^^^^^^^^LLLLLLLLLLLLLLLLLLLL^^^^^^^^^^^^^^^^^^#
#^^^^^^^^^LLLLLLLLLLLLLLLLLLLLL^^^^^^^^^^^^^^^^^^#
#^^^^^^^^^^LLLLLLLLLLLLLLLLLLLL^^^^^^^^^^^^^^^^^^#
#^^^^^^^^^^^LLLLLLLLLLLLLLLLLL^^^^^^^^^^^^^^^^^^^#
#^^^^^^^^^^^^^^LLLLLLLLLLLLL^^^^^^^^^^^^^^^^^^^^^#
#^^^^^^^^^^^^^^^^^^LLLLLLLL^^^^^^^^^^^^^^^^^^^^^^#
#^^^^^^^^^^^^^^^^^^^^^^LLLLL^^^^^^^^^^^^^^^^^^^^^#
#^^^^^^^^^^^^^^^^^^^^^^^LLLLL^^^^^^^^^^^^^^^^^^^^#
#^^^^^^^^^^^^^^^^^^^^^^LLLLL^^^^^^^^^^^^^^^^^^^^^#
#^^^^^^^^^^^^^^^^^^^^^^^LLLLL^^^^^^^^^^^^^^^^^^^^#
#^^^^^^^^^^^^^^^^^^^^^^LLLLL^^^^^^^^^^^^^^^^^^^^^#
##################################################
